{"type": "map",
  "width": 12,
  "height" : 18,
  "map" : [
    [0,1,0,1,0,0,0,0,0,2,2,0],
    [0,0,0,0,2,0,1,2,0,0,1,2],
    [0,0,0,0,0,0,0,0,0,0,0,0],
    [0,0,0,0,0,0,0,0,0,1,1,0],
    [0,0,0,0,0,2,0,0,1,1,0,0],
    [0,0,0,0,0,0,0,0,0,2,0,0],
    [0,0,0,0,1,0,0,0,1,2,0,0],
    [2,0,0,0,0,0,0,0,0,0,0,0],
    [2,0,0,0,1,2,1,0,0,0,0,0],
    [2,0,0,1,2,2,2,0,0,0,0,0],
    [0,2,0,0,1,2,1,0,0,0,0,0],
    [2,0,0,0,0,0,0,0,0,0,0,0],
    [0,0,0,0,0,0,0,0,0,1,0,0],
    [0,0,0,0,0,0,1,0,0,0,2,0],
    [1,1,0,0,0,0,0,0,0,0,0,2],
    [1,0,0,0,1,0,0,0,0,0,2,2],
    [1,1,0,0,0,0,0,0,0,0,1,0],
    [0,0,1,0,0,0,0,0,0,1,1,0],
    [0,0,0,1,0,0,1,0,0,0,0,0]
  ],
  "textures" : "assets/map/textures/Ash_planet/Ash_planet_bitmap.png",
  "unwalkableTiles" : [2]
}
