{ "type": "map",
  "width": 12,
  "height" : 18,
  "map" : [
    [0,1,0,1,1,1,0,0,1,0,0,0],
    [0,0,0,0,0,0,1,1,2,2,0,0],
    [0,0,0,2,0,2,2,2,2,2,2,0],
    [0,2,2,0,0,2,0,0,2,2,2,0],
    [0,0,0,0,0,0,0,0,2,0,0,0],
    [0,0,2,0,0,0,0,0,0,1,0,0],
    [0,0,0,0,2,0,0,0,1,0,0,0],
    [0,0,0,0,0,1,1,1,2,1,0,0],
    [0,0,0,0,2,0,0,0,1,0,0,0],
    [0,0,0,0,0,0,0,0,0,0,0,0],
    [2,2,2,2,0,0,0,0,0,2,2,0],
    [2,2,0,0,0,0,0,2,0,0,0,0],
    [0,0,0,0,0,2,2,2,0,0,0,0],
    [0,0,0,1,1,0,0,0,0,0,0,0],
    [0,0,1,1,0,0,0,0,1,0,0,0],
    [0,2,2,0,1,0,1,1,1,1,0,0],
    [2,2,2,0,0,0,1,1,0,2,2,0],
    [0,0,1,0,0,0,0,0,2,2,0,0],
    [0,0,0,1,2,2,1,0,0,2,0,0]
  ],
  "textures" : "assets/map/textures/Grass_planet/grass_bitmap.png",
  "unwalkableTiles" : [2]
}
